weave          	/wi:v/              	v.编(织) n.编织法，编织式样   
nevertheless   	/ˌnevəðə'les/       	conj.(nonetheless)然而,不过ad.仍然,不过
spur           	/spə:/              	n.靴刺,马刺;刺激,刺激物 v.刺激,激励
pat            	/pæt/               	v.                  
emphasize      	/'emfəsaiz/         	v.(emphasise)强调     
fatigue        	/fə'ti:g/           	n.                  
insure         	/in'ʃuə/            	vt.保险,给…保险;保证       
isolate        	/'aisəleit/         	vt.隔离,孤立            
temporary      	/'tempərəri/        	a.暂时的,临时的           
identify       	/aɪ'dentɪfaɪ/       	v.识别,鉴别;(with)把…和…看成一样
liberal        	/'libərəl/          	a.慷慨的,大方的;富足的;自由的,思想开放的
register       	/'redʒistə/         	n.                  
significance   	/sig'nifikəns/      	n.意义,含义;重要性,重要的     
exterior       	/ik'stiəriə/        	a.外部的,外面的 n.外部      
auxiliary      	/ɔ:g'ziljəri/       	a.辅助的，支援的 n.辅助者，辅助设备
breed          	/bri:d/             	v.(使)繁殖,生殖;产生;教养,抚养 n.品种
dash           	/dæʃ/               	v.                  
acquire        	/ə'kwaiə/           	v.获得；学到(知识等)；养成(习惯) 
genuine        	/'dʒenjuin/         	a.真正的,名副其实的         
neglect        	/ni'glekt/          	v.                  
sensitive      	/'sensətɪv/         	a.(to)敏感的,易受伤害的;灵敏的 
expand         	/ik'spænd/          	v.(使)膨胀,(使)扩张;张开,展开 
odd            	/ɔd/                	a.奇数的;奇怪的;单只的;临时的;带零头的
waist          	/weist/             	n.腰,腰部              
transmit       	/trænz'mit/         	vt.传输               
witness        	/'witnis/           	n.目击者,证人;证据,证明 v.目击,目睹;作证
evil           	/'i:vəl/            	a.邪恶的,罪恶的 n.邪恶,罪恶   
prior          	/'praiə/            	a.优先的,在前的;(to)在…之前  
vague          	/veig/              	a.不明确的,含糊的,暧昧的      
participate    	/pɑ:'tɪsɪpeɪt/      	v.(in)参与,参加;分享,分担;含有,带有
essential      	/i'senʃəl/          	a.本质的,基本的;净化的 n.本质;要素
continual      	/kən'tinjuəl/       	a.不断的,连续的,频繁的       
mere           	/miə/               	a.纯粹的;仅仅,只不过        
invade         	/in'veid/           	vt.入侵,侵略,侵袭,侵扰      
remedy         	/'remidi/           	n.药品;治疗措施 v.治疗,医治;纠正,补救
clue           	/klu:/              	n.线索,暗示             
triangle       	/'traiæŋgl/         	n.三角(形)             
triumph        	/'traiəmf/          	n.胜利,成功 v.得胜,战胜     
spray          	/spreɪ/             	n.喷雾,飞沫,浪花,水花 v.喷,喷射
index          	/'indeks/           	n.(pl.indexes,indices)索引 v.附以索引
jungle         	/'dʒʌŋgl/           	n.丛林,生死地带           
award          	/ə'wɔ:d/            	vt.授予,给予；判定 n.奖,奖金；仲裁
commit         	/kə'mit/            	v.把…交托给,提交;犯(错误),干(坏事)
torture        	/'tɔ:tʃə/           	v.拷问,拷打;折磨,磨难 n.拷问;折磨,痛苦
import         	/im'pɔ:t/           	v.                  
hollow         	/'hɔləu/            	a.空的,中空的;空洞的,空虚的 v.挖空,凿空
violence       	/'vaiələns/         	n.猛烈,强烈;暴力,暴行;强暴    
garbage        	/'gɑ:bidʒ/          	n.垃圾                
organ          	/'ɔ:gən/            	n.器官;机构,机关;风琴       
spot           	/spɔt/              	n.斑点;地点 v.认出,认清,发现;玷污,弄脏
enthusiasm     	/in'θju:ziæzəm/     	n.热情,热心;狂热;积极性(for) 
oral           	/'ɔ:rəl/            	a.口头的               
tedious        	/'ti:diəs/          	a.乏味的,单调的,冗长的       
shift          	/ʃift/              	v.替换,转移n.转换,转变;(轮)班,(换)班
personnel      	/ˌpə:sə'nel/        	n.全体人员,全体职员;人事(部门)  
principle      	/'prinsəpl/         	n.原理,原则;主义,信念       
bachelor       	/'bætʃələ/          	n.单身汉;(亦作B-)学士(学位)  
favorable      	/'feivərəbl/        	a.(favourable)赞许的,有利的,讨人喜欢的
interfere      	/ˌintə'fiə/         	v.(in)干涉,干预;(with)妨碍,打扰
external       	/ik'stə:nəl/        	a.外部的;客观的;外国的;表面的;[医]外用的
universal      	/ˌju:ni'və:səl/     	a.普遍的,全体的,通用的;宇宙的,世界的
expenditure    	/iks'penditʃə/      	n.花费;(时间,金钱等的)支出,消耗 
presumably     	/pri'zju:-məbli/    	ad.推测起来,大概          
substance      	/'sʌbstəns/         	n.物质；实质，本质；主旨；财产，资产 
decent         	/'di:sənt/          	a.体面的;正派的,合乎礼仪的;合适的 
ban            	/bæn/               	v.取缔,查禁;(from)禁止 n.禁止,禁令
passive        	/'pæsiv/            	a.被动的,消极的           
infer          	/in'fə:/            	v.推论,推断             
domestic       	/dəu'mestik/        	a.家里的;本国的;驯养的       
tropical       	/'trɔpikəl/         	a.热带的               
minimum        	/'miniməm/          	n.最小值,最低限度 a.最小的,最低的
precaution     	/pri'kɔ:ʃən/        	n.预防,谨慎,警惕          
mixture        	/'mikstʃə/          	n.混合;混合物,混合剂        
available      	/ə'veɪləbl/         	a.(用于物)可用的；可见到的，接受采访的
resemble       	/ri'zembl/          	v.像,类似              
personal       	/'pə:sənl/          	a.个人的,私人的;亲自的;身体的,人身的
restrict       	/ri'strikt/         	v.限制,约束             
origin         	/'ɔridʒin/          	n.起源,由来;出身,来历       
recruit        	/ri'kru:t/          	v.征募(新兵)，吸收；补充 n.新成员，新兵
female         	/'fi:meil/          	n.女性;女人;雌兽 a.女性的;雌的;柔弱的
export         	/ik'spɔ:t/          	v.                  
delay          	/di'lei/            	v.                  
smash          	/smæʃ/              	v.                  
necessity      	/ni'sesəti/         	n.必要性,需要;必然性;(pl.)必需品
peak           	/pi:k/              	n.山顶,最高点;峰,山峰 a.高峰的,最高的
vacuum         	/'vækjuəm/          	n.真空,真空吸尘器          
resolve        	/ri'zɔlv/           	v.决心;(使)分解,溶解;决议 n.解决;决心
calculate      	/'kælkjuleit/       	v.计算,推算;计划,打算       
arbitrary      	/'ɑ:bitrəri/        	a.任意的，任性的，主观的；专断，武断的
abundant       	/ə'bʌndənt/         	a.大量(充足)的；(in)丰富(富裕)的
nonsense       	/'nɔnsəns/          	n.胡说,废话             
consistent     	/kən'sistənt/       	a.(in)前后一致的；（with）一致，符合
sequence       	/'si:kwəns/         	n.先后,次序;连续,数列       
primitive      	/'primitiv/         	a.原始的,远古的,早期的;粗糙的,简单的
marvelous      	/'mɑ:viləs/         	a.(marvellous)惊人的,奇迹般的,妙极的
tremendous     	/trə'mendəs/        	a.巨大的,极大的           
interpret      	/in'tə:prit/        	vt.解释,说明;口译         
generate       	/'dʒenəreɪt/        	vt.产生,发生;生殖         
continuous     	/kən'tinjuəs/       	a.连续的,持续的           
temptation     	/temp'teiʃən/       	n.引诱，诱惑；诱惑物         
holy           	/'həuli/            	a.神圣的,圣洁的           
bunch          	/'bʌntʃ/            	n.(一)簇,束,捆,串        
substantial    	/səb'stænʃəl/       	a.实质的;相当的;显著的;坚固的;富裕的
tissue         	/'tɪʃu:/            	n.织物,薄绢,纸巾;(动,植物的)组织
release        	/ri'li:s/           	v.释放,解放;发表,发行 n.释放,豁免,放松
obscure        	/əb'skjuə(r)/       	a.暗的,朦胧的;模糊的,晦涩的    
flash          	/flæʃ/              	n.                  
prohibit       	/prəu'hibit/        	v.禁止,不准;阻止          
vain           	/veɪn/              	a.徒劳的,徒然的;自负的,爱虚荣的  
catalog        	/'kætəlɔg/          	n.（catalogue）目录(册) v.编目(录)
applause       	/ə'plɔ:z/           	n.鼓掌；喝彩；夸奖，赞扬       
jam            	/dʒæm/              	n.阻塞,轧住;果酱 v.(使)阻塞,(使)轧住不动
radical        	/'rædikəl/          	a.基本的,重要的;激进的,极端的;根本的
subsequent     	/'sʌbsikwənt/       	a.随后的,后来的           
network        	/'netwə:k/          	n.网状物;广播网,电视网;网络    
adopt          	/ə'dɔpt/            	vt.采用，采取(态度等)；选定；收养 
secure         	/si'kjuə/           	a.(from,against)安全的,放心的v.得到;防护
tension        	/'tenʃən/           	n.(紧张)状态；拉(绷)紧；张力，拉力
passion        	/'pæʃən/            	n.热情,激情,爱好;激怒;强烈感情  
motivate       	/'məutiveit/        	vt.促动；激励，鼓励，作为…的动机  
defect         	/'di:fekt/          	n.过失;缺点;不足          
explosion      	/ɪk'spləuʒn/        	n.爆炸,爆发             
discount       	/'diskaunt/         	n.折扣；贴现(率) vt.打折扣;不重视
shuttle        	/'ʃʌtl/             	n.往返汽车              
suspicion      	/sə'spiʃən/         	n.怀疑，猜疑；一点儿，少量      
career         	/kə'rɪə(r)/         	n.(个人的)事业；专业，生涯，职业，经历
oppose         	/ə'pəuz/            	v.反对,使对立,使对抗,使相对    
evaluate       	/i'væljueit/        	v.估价,评价;求…的值        
dusk           	/dʌsk/              	n.薄暮,黄昏             
religion       	/ri'lidʒən/         	n.宗教,信仰             
community      	/kə'mju:niti/       	n.同一地区的全体居民,社会,社区;共同体
wagon          	/'wægən/            	n.运货马车,运货车;敞蓬车厢     
launch         	/lɔ:ntʃ/            	v.发射;使(船)下水,发动,开展 n.发射,下水
competition    	/ˌkɔmpi'tiʃən/      	n.竞争，比赛；角逐，较量；[总称]竞争者
mood           	/mu:d/              	n.心情,情绪;语气          
expansion      	/ik'spænʃən/        	n.扩张,膨胀;张开,伸展       
exceedingly    	/ik'si:diŋli/       	ad.极端地,非常           
devise         	/dɪ'vaɪz/           	vt.设计;发明;图谋;作出(计划);想出(办法)
joint          	/dʒɔint/            	n.接合处,接头;关节a.联合的,共同的,连接的
delicate       	/'delikət/          	a.纤弱的;精致的;微妙的;灵敏的   
mild           	/maild/             	a.温和的,轻微的,味淡的,不含有害物质的的
likelihood     	/'laiklihud/        	n.可能性               
data           	/'deitə/            	n.(datum的复数)资料，数据   
subtract       	/səb'trækt/         	v. (from)减(去)       
ridiculous     	/ri'dikjuləs/       	a.荒谬的,可笑的           
simplicity     	/sim'plisiti/       	n.简单,简易;朴素;直率,单纯    
harmony        	/'hɑ:məni/          	n.协调,和谐;融洽          
stale          	/steil/             	n.变质的,不新鲜的;陈旧的,陈腐的  
deaf           	/def/               	a.聋的;不愿听的           
competent      	/'kɔmpitənt/        	a.有能力的，能胜任的；足够的     
ridge          	/ridʒ/              	n.岭,山脉;屋脊;鼻梁        
explode        	/ik'spləud/         	v.(使)爆炸,(使)爆发       
adjust         	/ə'dʒʌst/           	vt.调节；整顿，调整 vi.适应(to)；使调节
estimate       	/'estimeit/         	v.                  
equation       	/i'kweiʒən/         	n.(数学)等式,方程式;(with)相等;均衡
mission        	/'miʃən/            	n.使命,任务;使团,代表团      
zone           	/zəun/              	n.地区,区域 v.分区,划分地带   
oblige         	/ə'blaɪdʒ/          	v.强迫,迫使;责成;(使)感激,施恩于
maximum        	/'mæksiməm/         	n.最大值,极限 a.最大的,最高的  
cargo          	/'kɑ:gəu/           	n.船货,货物             
agent          	/'eidʒənt/          	n.代理人；代理商；产生作用的人或事物 
drift          	/drift/             	v.                  
tide           	/taid/              	n.潮,潮汐;潮流,趋势        
vessel         	/'vesəl/            	n.容器,器皿;船,舰;管,血管    
outset         	/'autset/           	n.开始,开端             
scale          	/skeil/             	n.刻度;天平,磅秤;比例尺;规模;音阶;鱼鳞
revenue        	/'revənju:/         	n.财政收入,税收           
expensive      	/ik'spensiv/        	a.花费的,昂贵的           
spit           	/spit/              	v.吐(唾沫),吐痰 n.唾液     
abuse          	/ə'bju:z/           	vt.滥用；辱骂；诋毁 n.滥用；恶习；弊端
maintain       	/mein'tein/         	v.维修,保养,维持,供养,坚持,主张,支持
legislation    	/ˌledʒis'leiʃən/    	n.法律(规)；立法，法律的制定(或通过)
vacant         	/'veikənt/          	a.空的,未占用的;空缺的;神情茫然的 
approximate    	/ə'prɔksimit/       	a.近似的 vi.(to)接近     
resume         	/rezju:'mei/        	n.个人简历 v.再继续,重新开始;再用;恢复
sorrow         	/'sɔrəu/            	n.悲衰,悲痛             
reluctant      	/ri'lʌktənt/        	a.不愿的,勉强的           
geography      	/dʒi'ɔgrəfi/        	n.地理(学)             
optional       	/'ɒpʃənl/           	a.可以任选的,随意的,非强制的    
consume        	/kən'sju:m/         	vt.消耗；吃完，喝光；(with)使着迷；烧毁
comparative    	/kəm'pærətiv/       	a.比较的,相当的           
excess         	/ik'ses/            	a.过量的,额外的 n.过量;过剩;超额;无节制
rigid          	/'ridʒid/           	a.刚性的;刻板的;严厉的       
entertainment  	/ˌentə'teinmənt/    	n.招待,款待;表演文娱节目      
respond        	/ri'spɔnd/          	v.回答,响应,作出反应        
awful          	/'ɔ:fl/             	a.极度的，极坏的；威严的，可怕的   
numerous       	/'nju:mərəs/        	a.众多的,许多的,大批的       
haste          	/heist/             	n.匆忙,急速;草率 v.赶快;匆忙  
parallel       	/'pærəlel/          	a.平行的,相同的,类似的n.平行线,类似,对比
approve        	/ə'pru:v/           	v.(of)赞成，同意；批准，审议，通过
vocabulary     	/və'kæbjələri/      	n.词汇,词汇量;词汇表        
version        	/'və:ʃən/           	n.版本;译本,译文;说法       
decay          	/di'kei/            	v.                  
column         	/'kɔləm/            	n.圆柱,柱状物;列;(报刊中的)专栏 
ceremony       	/'seriməuni/        	n.典礼,仪式;礼节,礼仪       
extent         	/ik'stent/          	n.广度,宽度,长度;程度,限度    
moral          	/'mɔrəl/            	a.道德(上)的,精神上的 n.寓意,教育意义
glimpse        	/glimps/            	n.                  
prospect       	/'prɔspekt/         	n.景色;前景,前途,展望       
luxury         	/'lʌkʃəri/          	n.奢侈,华贵;奢侈品 a.奢华的,豪华的
collision      	/kə'lɪʒn/           	n.碰撞；(利益，意见等的)冲突，抵触 
exclusive      	/ik'sklu:siv/       	a.独占的;排他的;孤高的;唯一的;高级的
provision      	/prəu'viʒən/        	n.供应,(一批)供应品;预备;条款;(pl.)给养
agency         	/'eidʒənsi/         	n.代理(处)；代办处；[美](政府的)机关，厅
snap           	/snæp/              	v.啪地移动；(使）突然断开，断开（成两截)
route          	/ru:t/              	n.路线,路程             
attach         	/ə'tætʃ/            	v.系，贴，连接；使成为一部分；使依恋 
display        	/ˌdis'plei/         	v.                  
male           	/meil/              	n.                  
deputy         	/'depjuti/          	n.代理人,代表 a.副的,代理的   
episode        	/'epɪsəud/          	n.一段情节;片断;(连续剧的)一集  
forbid         	/fə'bɪd/            	v.禁止,不许             
exclude        	/iks'klu:d/         	v.拒绝,把…排除在外,排斥      
beforehand     	/bi'fɔ:hænd/        	ad.预先,事先            
slide          	/slaid/             	v.(使)滑动 n.滑坡,滑道;滑,滑动;幻灯片
aspect         	/'æspekt/           	n.样子, 外表, 面貌, (问题等的)方面
apparent       	/ə'pærənt/          	a.表面上的,貌似真实的；显然的,明明白白的
vivid          	/'vivid/            	a.鲜艳的;生动的,栩栩如生的     
transform      	/træns'fɔ:m/        	vt.改变,变换;变压;转化;改造,改造
grand          	/grænd/             	a.盛大的,豪华的;重大的,主要的   
slip           	/slip/              	v.滑,滑倒;滑掉;溜走n.疏忽,小错,口误,笔误
survey         	/sə:'vei/           	v.                  
gap            	/gæp/               	n.缺口;差距;空白;缺乏       
sincere        	/sin'siə/           	a.诚挚的,真实的,诚恳的       
appliance      	/ə'plaɪəns/         	n.电器；器械，装置；应用，适用    
skim           	/skim/              	vt.撇去(液体表面)之漂浮物 vi.轻轻掠过
volcano        	/vɔl'keinəu/        	n.火山                
slope          	/sləup/             	n.斜坡,斜面;倾斜,斜度 v.(使)倾斜
trace          	/treis/             	n.痕迹,踪迹;极少量 v.描绘;跟踪,追踪
thrust         	/θrʌst/             	vt.插入；猛推 n.插，推力 vi.刺，戳，冲
preserve       	/prɪ'zɜ:v/          	v.保护,维持;保存,保藏       
guilty         	/'gilti/            	a.(of)有罪的,内疚的       
discipline     	/'disiplin/         	n.纪律,学科             
disturb        	/dis'tə:b/          	v.扰乱,妨碍,使不安         
hostile        	/'hɔstail/          	a.敌对的,敌方的,敌意的       
fatal          	/'feitl/            	a.致命的,毁灭性的          
brake          	/breik/             	v.                  
cope           	/kəup/              	v.(with)竞争,对抗;(with)对付,妥善处理
yield          	/ji:ld/             	v.出产,生长;(to)屈服,服从 n.产量,收获
debate         	/di'beit/           	v.                  
arouse         	/ə'rəuz/            	vt.唤醒，叫醒；唤起，激起      
rival          	/'raivəl/           	n.竞争者,对手 v.竞争,对抗 a.竞争的
arise          	/ə'raɪz/            	v.出现，发生；(from)由…引起，由…产生
remarkable     	/ri'mɑ:kəbl/        	a.值得注意的;显著的,异常的,非凡的 
academy        	/ə'kædəmi/          	n.(高等)专科院校；学术社团,协会，研究院
reputation     	/ˌrepju'teiʃən/     	n.名誉,名声,声望          
cancel         	/'kænsl/            	v.取消,把…作废;删去,划掉     
notion         	/'nəuʃən/           	n.概念,想法,意念,看法,观点    
earnest        	/'ə:nist/           	a.热心的,诚挚的 n.热心;真挚;定金;认真
response       	/ri'spɔns/          	n.回答,响应,反应          
glorious       	/'glɔ:riəs/         	a.壮丽的,辉煌的;光荣的       
deposit        	/dɪ'pɒzɪt/          	v.存放;使沉淀;付(保证金) n.存款;沉积物
manufacture    	/ˌmænju'fæktʃə/     	v.制造,加工 n.制造,制造业;产品 
withdraw       	/wɪð'drɔ:/          	v.收回,撤消;缩回,退出;提取(钱) 
loose          	/lu:s/              	a.(宽)松的；不精确的；自由的，散漫的
withstand      	/wið'stænd/         	vt.抵抗,经受住           
retain         	/ri'tein/           	v.保持,保留             
internal       	/in'tə:nəl/         	a.内部的,内的;国内的,内政的    
strategy       	/'strætidʒi/        	n.战略，策略；对策，政策       
hint           	/hint/              	n.暗示,提示,线索 v.暗示,示意  
scratch        	/skrætʃ/            	v.抓,搔,扒 n.抓,搔,抓痕;起跑线
undergo        	/ˌʌndə'gəu/         	vt.遭受,经历,承受         
gear           	/giə/               	n.齿轮,传动装置 v.(to)调整,使适合
bureau         	/'bjuərəu/          	n.署,局,司,处           
intimidate     	/in'timideit/       	vt.胁迫，威胁(某人做某事)     
virtue         	/'və:tju:/          	n.德行,美德;贞操;优点;功效,效力 
appreciate     	/ə'pri:ʃieit/       	vt.为...表示感激，感谢；欣赏，赏识，评价
faculty        	/'fækəlti/          	n.才能;学院,系;(学院或系的)全体教学人员
appeal         	/ə'pi:l/            	vi.呼吁，恳求；申诉 n.呼吁；申诉；吸引力
virtual        	/'vɜ:tʃuəl/         	a.实际上的,事实上的         
chaos          	/'keɪɒs/            	n.混乱,紊乱             
loosen         	/'lu:sən/           	v.解开,放松             
humble         	/'hʌmbl/            	a.谦卑的,恭顺的;地位低下的 v.降低,贬低
dumb           	/dʌm/               	a.哑的,无言的            
incident       	/'insidənt/         	n.事件,事变             
victim         	/'viktim/           	n.牺牲品,受害者           
appetite       	/'æpitait/          	n.食欲，胃口；欲望，性欲；爱好，趣味 
globe          	/gləub/             	n.球体,地球仪;地球,世界      
expel          	/ik'spel/           	v.把…开除;驱逐;排出;发射     
relevant       	/'reləvənt/         	a.有关的,中肯的,相应的,实质性的  
expense        	/ik'spens/          	n.花费,消费,消耗          
prevail        	/pri'veil/          	v.(over,against)取胜,占优势;流行,盛行
private        	/'praɪvət/          	a.私人的,个人的,秘密的,私下的   
gaze           	/geiz/              	v.                  
exploit        	/'eksplɔit/         	v.开拓;开发;剥削 n.功绩[勋];业绩
facility       	/fə'sɪləti/         	n.灵巧,熟练;(pl.)设备,设施,便利条件
coach          	/kəutʃ/             	n.长途公共汽车；教练 vt.训练，指导，培训
insurance      	/in'ʃuərəns/        	n.保险,保险费,保险业        
professional   	/prə'feʃənəl/       	a.职业的,专门的 n.自由职业者,专业人员
submit         	/səb'mɪt/           	v.(to)使服从,屈服;(to)呈送,提交
awkward        	/'ɔ:kwəd/           	a.笨拙的；尴尬的；使用不便的；难处理的
highlight      	/'hailait/          	v.使显著,使突出;强调 n.最精彩的部分
nuclear        	/'nju:kliə/         	a.核心的,中心的;原子核的,核能的  
remote         	/ri'məut/           	a.远的,遥远的,疏远的,偏僻的,细微的
descend        	/di'send/           	v.下来,下降;遗传(指财产,气质,权利)
alter          	/'ɔ:ltə(r)/         	vt.改变，更改；改做(衣服) vi.改变，变化
durable        	/'djuərəbl/         	a.持久的,耐久的           
semester       	/si'mestə/          	n.学期                
priority       	/prai'ɔrəti/        	n.先,前;优先,重点,优先权     
faulty         	/'fɔ:lti/           	a.有错误的，有缺点的，不完善的    
weed           	/wi:d/              	n.杂草,野草 v.除草,锄草     
reinforce      	/ˌri:in'fɔ:s/       	v.增援,加强             
integrate      	/'intigreit/        	v.(into,with)(使)成为一体,(使)结合在一起
accelerate     	/ək'seləreit/       	v.使加速，使增速，促进 vi.加快，增加
junior         	/'dʒu:njə/          	a.                  
vital          	/'vaitəl/           	a.生死攸关的,重大的;生命的,生机的 
code           	/kəud/              	n.代码,代号,密码;法典,法规,规划 
trial          	/'traiəl/           	n.讯问，审讯；试验；试用；尝试    
twist          	/twist/             	v.捻;拧;扭曲;蜿蜒曲折而行 n.拧;歪曲;曲折
duration       	/dju'reɪʃn/         	n.持久;期间;持续时间        
inferior       	/in'fiəriə/         	a.下等的,下级的;劣等的,差的 n.下级,晚辈
explosive      	/ik'spləusiv/       	a.爆炸(性)的,爆发(性)的 n.爆炸物,炸药
germ           	/dʒə:m/             	n.微生物,细菌            
neutral        	/'nju:trəl/         	a.中立的;中性的,中和的       
shrink         	/ʃriŋk/             	v.起皱,收缩;退缩,畏缩       
evolution      	/ˌi:və'lu:ʃən/      	n.进化,演变,发展,进展       
compete        	/kəm'pi:t/          	vi.比赛；竞争；对抗         
extinct        	/ik'stiŋkt/         	a.灭绝的;熄灭了的          
massive        	/'mæsiv/            	a.大而重的,厚实的,粗大的;大规模的,大量的
idle           	/'aidl/             	a.空闲的,闲置的;懒散的 v.空费,虚度
battery        	/'bætri/            	n.电池(组)；(器具等的)一组，一套；炮兵连
exaggerate     	/ig'zædʒəreit/      	v.夸大,夸张             
extraordinary  	/ɪk'strɔ:dnri/      	a.非常的;格外的;意外的;离奇的;临时的
repetition     	/ˌrepi'tiʃən/       	n.重复,反复             
outstanding    	/ˌaut'stændiŋ/      	a.突出的,显著的,杰出的       
unique         	/ju:'ni:k/          	a.唯一的,独一无二的         
authority      	/ɔ:'θɔrəti/         	n.权力，权威；权威人士；(pl.)官方，当局
regulate       	/'regjuleɪt/        	v.管制,控制;调节,校准;调整    
vanish         	/'væniʃ/            	vi.突然不见;消失          
venture        	/'ventʃə/           	v.冒险,拼;大胆表示 n.冒险事业,拼,闯
calendar       	/'kælində/          	n.日历,月历             
academic       	/ˌækə'demik/        	a.学院的，大学的；学术性的；理论的  
usage          	/'ju:zidʒ/          	n.使用，用法；习惯，习俗；惯用法   
splendid       	/'splendid/         	a.壮丽的,辉煌的;极好的       
talent         	/'tælənt/           	n.才能,天资;人才          
acknowledge    	/ək'nɔlidʒ/         	vt.承认；接受；告知(信件等的)收到；答谢
urge           	/ə:dʒ/              	vt.催促;怂恿;强调 n.强烈欲望,迫切要求
expose         	/ik'spəuz/          	v.(to)使暴露,受到;使曝光    
opportunity    	/ˌɔpə'tju:niti/     	n.机会                
vehicle        	/'vi:ɪk(ə)l/        	n.车辆,交通工具;媒介,载体     
offend         	/ə'fend/            	v.犯罪,冒犯,违反,得罪,使...不愉快
avenue         	/'ævənju:/          	n.林荫路，大街；(比喻)途径，渠道，方法
sophisticated  	/sə'fistikeitid/    	a.尖端的,复杂的,先进的;老练的,老于世故的
trend          	/trend/             	n.倾向,趋势 vi.伸向,倾向    
rely           	/ri'lai/            	v.(on)依赖,依靠;信赖,信任   
boundary       	/'baundəri/         	n.分界线,边界            
leak           	/li:k/              	v.漏,泄漏 n.漏洞,漏隙;泄漏,漏出
deserve        	/di'zə:v/           	v.应受,值得             
appoint        	/ə'pɔint/           	vt.任命，委派；指定，约定(时间、地点等)
license        	/'laisəns/          	n.(licence)许可证,执照 v.准许,认可
echo           	/'ekəu/             	v.                  
dive           	/'di:vei/           	v.                  
security       	/sɪ'kjuərəti/       	n.安全(感),防御(物),保证(人),(pl.)证券
suspicious     	/sə'spiʃəs/         	a.(of)可疑的,多疑的,疑心的   
herd           	/hə:d/              	n.群,兽群,牛群 v.放牧,群集   
tend           	/tend/              	v.趋向,往往是;照料,看护      
focus          	/'fəukəs/           	n.焦点,(活动,兴趣等的)中心 v.(on)使聚集
shield         	/ʃi:ld/             	n.防护物,护罩;盾,盾状物 v.保护,防护
gesture        	/'dʒestʃə/          	n.姿势,姿态,手势 v.做手势    
capture        	/kæptʃə(r)/         	v.                  
barrier        	/'bæriə/            	n.栅栏,屏障;障碍(物)       
issue          	/'iʃju:/            	n.问题,争端,发行(物),期号 vt.发行,流出
restraint      	/ri'streint/        	n.抑制,制止             
timber         	/'timbə/            	n.木材,木料             
comparable     	/'kɔmpərəbl/        	a.(with,to)可比较的,比得上的
vibrate        	/vai'breit/         	v.(使)振动,(使)摇摆；受…而感动 
lean           	/li:n/              	v.倾斜,屈身;倚,靠,依赖 a.瘦的,无脂肪的
flock          	/flɔk/              	n.(一)群,(禽,畜等的)群;大量 v.群集,成群
leisure        	/'lɛʒə/             	n.空闲,闲暇;悠闲,安逸       
bundle         	/'bʌndl/            	n.捆,包,束             
bother         	/'bɔðə/             	vt.打扰，麻烦 vi.担心，烦恼 n.烦恼，焦急
marine         	/mə'ri:n/           	a.海的,海生的;船舶的,航海的    
scandal        	/'skændəl/          	n.丑闻,诽谤,耻辱,流言蜚语,反感,公愤
scan           	/skæn/              	v.细看,审视;浏览;扫描 n.扫描  
genius         	/'dʒi:niəs/         	n.天才                
notify         	/'nəutifai/         	v.通知,告知,报告          
glory          	/'glɔ:ri/           	n.光荣,荣誉             
urgent         	/'ə:dʒənt/          	a.急迫的，紧要的，紧急的       
distinguish    	/dis'tiŋgwiʃ/       	v.(from)区别,辨别;辨认出;使杰出
alcohol        	/'ælkəhɔl/          	n.酒精，乙醇；含酒精的饮料      
lunar          	/'lju:nə/           	a.月亮的               
region         	/'ri:dʒən/          	n.地区,地带,行政区,(科学等)领域 
lest           	/lest/              	conj.惟恐,免得          
household      	/'haushəuld/        	n.家庭，家人 a.家庭(务)的，家常的
relief         	/rɪ'li:f/           	n.(痛苦等)减轻,解除;援救,救济  
volume         	/'vɔlju:m/          	n.容积,体积;卷,册;音量      
diverse        	/dai'və:s/          	a.多种多样的,(from)不同的   
wander         	/'wɔndə/            	v.漫步,徘徊;迷路,迷失方向;离题  
decorate       	/'dekəreit/         	v.装饰,装璜,布置          
prosperity     	/prɔs'periti/       	n.繁荣,兴旺             
burst          	/bə:st/             	v.爆裂,炸破;突然发生 n.突然破裂,爆发
adhere         	/əd'hiə/            	vi.(to)粘着；坚持，遵守；依附，追随
coarse         	/kɔ:s/              	a.粗糙的,粗劣的;粗鲁的,粗俗的   
tone           	/təun/              	n.音调,音色;风气,气氛;腔调,语气;色调
stimulate      	/'stimjuleit/       	v.刺激,使兴奋;激励,鼓舞      
liquor         	/'likə/             	n.酒；溶液，液剂           
magnet         	/'mægnit/           	n.磁体,磁铁             
treaty         	/'tri:ti/           	n.条约，协议，协商          
exceed         	/ik'si:d/           	v.超过,胜过;越出          
blast          	/'baiəu/            	n.一阵(风);爆炸冲击波;管乐器声 v.爆炸
fertile        	/'fɜ:taɪl/          	a.肥沃的,富饶的;能繁殖的      
previous       	/'pri:vjəs/         	a.先前的,以前的           
core           	/kɔ:/               	n.果核;中心,核心          
promote        	/prəu'məut/         	v.促进,发扬;提升,提拔;增进,助长 
geometry       	/dʒi'ɔmitri/        	n.几何(学)             
encounter      	/in'kauntə/         	n.                  
restrain       	/ri'strein/         	v.(from)抑制,制止       
burden         	/'bə:dən/           	n.担子，重担，负担 vt.给予负担或麻烦
motive         	/'məutiv/           	n.动机,目的 a.发动的,运动的   
vary           	/'vεəri/            	vt.改变,变化;使多样化       
global         	/'gləubəl/          	a.球形的;全球的,全世界的;全面的  
transport      	/'trænspɔ:t /       	v.运输,运送,搬运n.运输;运输系统,运载工具
opponent       	/ə'pəunənt/         	n.对手,反对者,敌手 a.对立的,对抗的
applicable     	/'æplikəbl/         	a.可应用(实施)的；适当的,合适的  
shelter        	/'ʃeltə/            	n.掩蔽处;掩蔽,保护 v.掩蔽,躲避,庇护
removal        	/ri'mu:vəl/         	n.移动,迁居;除去          
valley         	/'væli/             	n.(山)谷;流域           
undertake      	/ˌʌndə'teik/        	v.承担,担任;许诺,保证;着手,从事 
hatred         	/'heitrid/          	n.憎恨,憎恶,怨恨          
negative       	/'negətiv/          	a.否定的,消极的,阴性的n.负数;(摄影)底片
cliff          	/klif/              	n.悬崖;峭壁             
variation      	/ˌvεəri'eiʃən/      	n.变化,变动;变种,变异       
whatsoever     	/ˌhwɔtsəu'evə/      	ad.(用于否定句中以加强语气)任何  
exclaim        	/ik'skleim/         	v.呼喊,惊叫,大声说         
stuff          	/stʌf/              	n.原料,材料,东西 v.填满,塞满  
render         	/'rendə/            	v.使得,致使;提出,提供,呈报    
pursue         	/pə'sju:/           	v.追赶,追踪;继续,从事       
title          	/'taitl/            	n.书名,标题;头衔,称号       
variable       	/'vεəriəbl/         	a.易变的;可变的;变量的 n.变量  
tidy           	/'taidi/            	a.整洁的,整齐的 v.整理,收拾   
slender        	/'slendə/           	a.修长的,细长的,苗条的;微小的,微薄的
tendency       	/'tendənsi/         	n.趋势，趋向；倾向          
sketch         	/sketʃ/             	n.素描;略图,草图;梗概 v.绘略图,速写,写生
sake           	/seik/              	n.缘故,理由             
hence          	/hens/              	ad.从此,今后;因此         
whereas        	/hwεə'æz/           	conj.而,却,反之         
casual         	/'kæʒjuəl/          	a.偶然的,碰巧的;临时的,非正式的  
nuisance       	/'nju:səns/         	n.讨厌的人(或东西);麻烦事     
emotion        	/i'məuʃən/          	n.情绪,情感,感情          
illegal        	/ɪ'li:gl/           	a.不合法的,非法的          
tender         	/'tendə(r)/         	a.嫩的;敏感的;温柔的 v.提出,提供;投标
decline        	/di'klain/          	v.下降,衰落;拒绝 n.下降;斜面,倾斜,衰落
elaborate      	/i'læbərət/         	v.                  
device         	/dɪ'vaɪs/           	n.装置,设备,仪表;方法,设计    
spill          	/spil/              	v.溢出,溅出 n.摔下,跌下     
valid          	/'vælɪd/            	a.有效的;有根据的;正当的      
conservation   	/ˌkɔnsə'veiʃən/     	n.保存,保护,保守;守恒,不灭    
obstacle       	/'ɒbstəkl/          	n.障碍(物),妨碍,阻碍,干扰    
dump           	/dʌmp/              	v.倾倒,倾卸 n.垃圾场       
