found          	/faund/             	vt.建立;创立;创办;使有根据;铸造;熔制
constrain      	/kən'strein/        	vt.限制，约束；克制，抑制      
duplicate      	/'dju:plikət/       	n.复制品 v.复写,使加倍 a.复制的,二重的
cotton         	/'kɔtən/            	n.棉花;棉线,棉纱;棉制品      
rein           	/rein/              	n.缰绳,统治,支配 v.驾驭,控制,统治
suppress       	/sə'pres/           	v.镇压,压制;抑制,忍住;查禁    
fabricate      	/'fæbrikeit/        	v.捏造,编造(谎言,借口等);建造,制造
repression     	/ri'preʃən/         	n.压抑，压制，镇压          
boss           	/bɔs/               	n.老板，上司 vt.指挥，控制，发号施令
moderate       	/'mɔdərət/          	a.有节制的,中等的,适度的,温和的,稳健的
refrain        	/ˌri:'frein/        	v.节制,避免,制止 n.(诗的)叠句 
fiber          	/faɪbə/             	n.(fibre)纤维;构造;纤维制品 
inhibit        	/in'hibit/          	vt.抑制，约束            
horn           	/hɔ:n/              	n.(牛羊等的)角;号,喇叭;角状物;角制品
console        	/kən'səul /         	n.控制台，仪表板；落地柜 vt.安慰，慰问
restrict       	/ri'strikt/         	v.限制,约束             
develop        	/di'veləp/          	v.发展,开发,研制;显现,显影;发育,生长
institute      	/'institjut/        	n.学会,研究所;学院 v.设立,设置,制定
compile        	/kəm'pail/          	vt.编辑，编制，搜集         
oppress        	/ə'pres/            	v.压迫,压制             
