temperature    	/'temprətʃə(r)/     	n.温度，体温；热度，发烧       
consolidate    	/kən'sɔlideit/      	v.使加固，使加强；(把...)联为一体，合并
organism       	/'ɔ:gənizəm/        	n.生物，有机体            
taste          	/teist/             	v.品尝;(of)有…味道;体验 n.滋味;味觉
solid          	/'sɔlid/            	a.固体的;结实的,稳固的,可靠的 n.固体
physical       	/'fɪzɪkl/           	a.物质的;肉体的,身体的;自然科学的,物理的
chamber        	/'tʃeimbə/          	n.房间，室；会议室；议院；(动物体内)腔室
muscle         	/'mʌsl/             	n.肌肉,体力             
unanimous      	/ju:'næniməs/       	a.全体一致的,一致同意的       
personnel      	/ˌpə:sə'nel/        	n.全体人员,全体职员;人事(部门)  
unity          	/'ju:niti/          	n.团结;统一,一致,整体       
board          	/bɔ:d/              	n.板,木板;全体委员;伙食 v.上船(车,飞机)
universal      	/ˌju:ni'və:səl/     	a.普遍的,全体的,通用的;宇宙的,世界的
type           	/taip/              	n.型式，类型；印刷字体；活      
decent         	/'di:sənt/          	a.体面的;正派的,合乎礼仪的;合适的 
constitution   	/ˌkɒnstɪ'tju:ʃn/    	n.构成,构造,组成(方式),成分;体格;宪法
mosaic         	/məu'zeiik/         	n.马赛克;镶嵌体           
jury           	/'dʒuəri/           	n.陪审团;全体评审员         
cube           	/kju:b/             	n.立方形,立方体;立方,三次幂    
personal       	/'pə:sənl/          	a.个人的,私人的;亲自的;身体的,人身的
naked          	/'neikid/           	a.裸体的,无遮敝的,无掩饰的     
republic       	/ri'pʌblik/         	n.共和国,共和政体          
