expression     	/ɪk'spreʃn/         	n.表达;表情;声调;腔调;榨出;措词;式;符号
spectacular    	/spek'tækjulə/      	a.壮观的,引人注目的 n.壮观的演出 
outlet         	/'autlet/           	n.出路,出口;销路,市场;发泄方法;电源插座
quota          	/'kwəutə/           	n.(生产、进出口等的)配额，(移民的)限额
sell           	/sel/               	v.卖,出售              
recognize      	/'rekəgnaɪz/        	v.(recognise)认出,承认,公认,赏识,表扬
exhibit        	/ig'zibit/          	v.展出,陈列 n.展览品,陈列品   
locate         	/ləu'keit/          	v.查出,探出,查找…地点,使…坐落于,位于
plead          	/pli:d/             	v.恳求,请求;为…辩护;提出…为理由 
boom           	/bu:m/              	v.迅速发展,兴旺;发出隆隆声     
present        	/'prezənt/          	a.出席的,现在的 n.现在,礼物 v.赠送,提出
post           	/pəust/             	v.贴出;公告;投寄 n.(支)柱;邮政,邮寄;职位
indicate       	/'indikeit/         	v.指出,指示;表明,暗示       
betray         	/bi'trei/           	v.背叛,出卖;暴露,流露,泄露    
tour           	/tuə/               	n.旅游，旅行；巡回演出        
spot           	/spɔt/              	n.斑点;地点 v.认出,认清,发现;玷污,弄脏
predominant    	/ˌpri'dɔminənt/     	a.(over)占优势的;主要的,突出的
introduce      	/ˌintrə'dju:s/      	vt.介绍；引进，传入；提出(议案等) 
expenditure    	/iks'penditʃə/      	n.花费;(时间,金钱等的)支出,消耗 
hatch          	/hætʃ/              	v.孵,孵出;策划,图谋 n.舱口,小门
fame           	/feim/              	n.名声;名望;传说 vt使出名;传扬…的名
origin         	/'ɔridʒin/          	n.起源,由来;出身,来历       
draw           	/drɔ:/              	v.拉;画;汲取;引出;(to)挨近 n.平局;拖曳
