due            	/dju:/              	a.(to)应支付的;(车,船等)预定应到达的
fix            	/fiks/              	v.(使)固定;修理;安装;决定;注视 n.困境
absolute       	/'æbsəlju:t/        	a.绝对的，完全的；确实的，肯定的   
reserve        	/ri'zə:v/           	n.储备(物),储备金;缄默 v.保留,储备;预定
orientation    	/ˌɔ:riən'teɪʃn/     	n.方向,方位,定位,倾向性,向东方  
conclude       	/kən'klu:d/         	v.结束,终止;断定,下结论;缔结,议定
assign         	/ə'sain/            	vt.派给，分配；选定，指定(时间、地点等)
conclusion     	/kən'klu:ʒən/       	n.结论，推论；结尾；缔结，议定    
deny           	/di'nai/            	v.否认,否定;拒绝          
liner          	/'lainə/            	n.班机,定期轮船,邮船        
settlement     	/'setlmənt/         	n.解决,决定,调停;居留区,住宅区  
award          	/ə'wɔ:d/            	vt.授予,给予；判定 n.奖,奖金；仲裁
suppose        	/sə'pəuz/           	v.料想,猜想;假定;conj.假使...结果会怎样
condition      	/kən'diʃən/         	n.条件，状况，环境 vt.决定；支配；训练
decide         	/di'said/           	v.决定,下决心;解决,裁决      
agreement      	/ə'gri:mənt/        	n.协定,协议；契约；达成协议；同意，一致
engagement     	/ɪn'geɪdʒmənt/      	n.约会,约定;婚约,订婚       
interim        	/'intərim/          	a.中间的,暂时的,临时的 n.过渡时期,暂定
institute      	/'institjut/        	n.学会,研究所;学院 v.设立,设置,制定
pact           	/pækt/              	n.合同,条约,公约,协定       
finite         	/'fainait/          	a.有限的；[数]有穷的,限定的    
anybody        	/'eniˌbɔdi/         	pron.(否定句)任何人；(肯定句)随便哪个人
premise        	/pri'maiz/          	n.前提,房屋连地基v.提论,预述,假定
