administer     	/əd'ministə/        	v.施行，实施；掌管，料理...的事务；给予
creep          	/kri:p/             	v.爬,爬行;(植物)蔓延       
examine        	/ig'zæmin/          	v.检查,调查;对…进行考试      
wind           	/wɪnd/              	n.风;气息 v.转动;缠绕;上发条,;蜿蜒而行
deceit         	/di'si:t/           	n.欺骗,欺骗行为           
conduct        	/'kɔndʌkt/          	n.行为,品行 v.引导;管理;指挥(乐队);传导
circuit        	/'sə:kit/           	n.环行,周线,巡回;电路,线路    
reptile        	/'reptail/          	n.爬行动物              
experiment     	/ik'speriment/      	n.实验;试验 v.(on)进行实验;做试验
official       	/ə'fɪʃl/            	n.官员,行政官员 a.官方的,官方的,正式的
fashionable    	/'fæʃənəbl/         	a.流行的,时髦的           
violence       	/'vaiələns/         	n.猛烈,强烈;暴力,暴行;强暴    
tour           	/tuə/               	n.旅游，旅行；巡回演出        
hold           	/həuld/             	v.拿着;保有;托住;举行;继续 n.握住;船舱
aircraft       	/'εəkrɑ:ft/         	n.飞机，飞船，飞行器         
procession     	/prəu'seʃən/        	n.队伍,行列             
buy            	/baɪ/               	vt.买，买得；向…行贿，收买vi.购买东西
breach         	/bri:tʃ/            	n.违反，不履行；破裂 vt.冲破，攻破
beg            	/beg/               	vt.请求，乞求 vi.恳请，行乞   
voyage         	/'vɔiidʒ/           	n.航海;航行;旅行          
journey        	/'dʒə:ni/           	n.旅行,旅程 v.旅行        
crime          	/kraim/             	n.罪行,犯罪             
sail           	/seil/              	n.帆,航行 v.航行         
deed           	/di:d/              	n.行为,行动;功绩,事迹;证书；契据 
