important      	/im'pɔ:tənt/        	a.重要的,重大的;有地位的,有权力的 
potential      	/pəu'tenʃəl/        	a.潜在的,可能的 n.潜能,潜力   
wit            	/wɪt/               	n.智力,才智,智慧          
strive         	/straiv/            	v.奋斗,努力             
sight          	/sait/              	n.视力;望见,瞥见;视域;眼界;情景,奇观
attempt        	/ə'tempt/           	vt.企图，试图 n.努力，尝试，企图 
resource       	/ri'sɔ:s/           	n.(pl.)资源,财力;办法,智谋;应变之才
persuasion     	/pə'sweiʒən/        	n.说服,说服力            
labor          	/'leibə/            	n.(labour)工作，劳动；劳力 v.劳动，苦干
immune         	/i'mju:n/           	a.免疫的,有免疫力的;有受影响的;豁免的
eloquent       	/'eləkwənt/         	a.雄辩的,有说服力的;善辩的,口才流利的
impetus        	/'ɪmpɪtəs/          	n.推动(力),促进          
sponsor        	/'spɔnsə/           	n.发起人,主力者,保证人 v.发起,主办
divert         	/dai'və:t/          	vt.使转向，使改道；转移(注意力)；使娱乐
effort         	/'efət/             	n.努力;成就;艰难的尝试       
painful        	/'peinfl/           	a.疼痛的,使痛苦的,费力[心]的,棘手的
violence       	/'vaiələns/         	n.猛烈,强烈;暴力,暴行;强暴    
muscle         	/'mʌsl/             	n.肌肉,体力             
strength       	/streŋθ/            	n.力量；实力；长处，优点；人力；兵力 
energy         	/'enədʒi/           	n.活力,精力;能,能量        
ear            	/iə/                	n.耳，耳朵；听力，听觉；穗      
heave          	/hi:v/              	v.(用力)举，提，拉；扔；拖；呕吐n.举起
might          	/mait/              	aux.v.可能,也许 n.力量,威力,权力
resistant      	/ri'zistənt/        	a.(to)抵抗的,有抵抗力的     
capable        	/'keipəbl/          	a.有本领的,有能力的;(of)可以…的,能…的
influence      	/'influəns/         	n.(on)影响,感化;势力,权势 v.影响,感化
