conscious      	/'kɔnʃəs/           	a.(of)意识到的,自觉的;神志清醒的
marginal       	/'mɑ:dʒɪnl/         	a.记在页边的,旁注的;(意识)边缘的 
spite          	/spait/             	n.恶意;怨恨             
remark         	/ri'mɑ:k/           	n.(about,on)评语,意见 v.(on)评论;注意到
significance   	/sig'nifikəns/      	n.意义,含义;重要性,重要的     
satisfactory   	/ˌsætis'fæktəri/    	a.令人满意的,圆满的,良好的,符合要求的
attract        	/ə'trækt/           	vt.引起的注意(或兴趣等),吸引；引起；激起
opinion        	/ə'pinjən/          	n.意见,看法,主张          
divert         	/dai'və:t/          	vt.使转向，使改道；转移(注意力)；使娱乐
forthcoming    	/'fɔ:θ'kʌmiŋ/       	a.即将到来的;准备好的;乐意帮助的;n.来临
meaning        	/'mi:niŋ/           	n.意思,意义,含义;重要性,价值   
idea           	/ai'diə/            	n.想法，念头；概念，观念；意见，主意 
advice         	/əd'vais/           	n.劝告，忠告，(医生等的)意见    
random         	/'rændəm/           	a.随机的,随意的 n.随机,随意   
desirable      	/di'zaiərəbl/       	a.值得做的;合意的,称心的;期望得到的
denote         	/di'nəut/           	vt.表示,意味着           
poisonous      	/'pɔizənəs/         	a.有毒的,恶意的,恶毒的,道德败坏的 
unanimous      	/ju:'næniməs/       	a.全体一致的,一致同意的       
please         	/pli:z/             	v.请;使愉快,使满意;喜欢,愿意   
agreement      	/ə'gri:mənt/        	n.协定,协议；契约；达成协议；同意，一致
skip           	/skip/              	vi.略过，跳过 n.跳跃 vt.故意忽略；略过
well           	/wel/               	ad.好，令人满意地；很 int.哎呀，好啦，嗯
malignant      	/mə'lignənt/        	a.恶性的，致命的；恶意的，恶毒的   
upset          	/ʌp'set/            	v.使…心烦意乱;打翻,推翻a.难过的;不安的
accept         	/ək'sept/           	vt.接受，领受；认可，同意 vi.同意，认可
imply          	/im'plai/           	v.意指,含…意思,暗示        
