outlet         	/'autlet/           	n.出路,出口;销路,市场;发泄方法;电源插座
interest       	/'ɪntrəst/          	n.(in)兴趣,重要性;利益v.(in)使发生兴趣
temperature    	/'temprətʃə(r)/     	n.温度，体温；热度，发烧       
wind           	/wɪnd/              	n.风;气息 v.转动;缠绕;上发条,;蜿蜒而行
muscular       	/'mʌskjulə/         	a.肌肉的;肌肉发达的;强健的     
inform         	/in'fɔ:m/           	v.(of,about)通知,告诉,报告;告发,告密
barber         	/'bɑ:bə/            	n.理发师               
sneeze         	/sni:z/             	vi.打喷嚏，发喷嚏声n.喷嚏     
generation     	/ˌdʒenə'reiʃən/     	n.产生,发生;一代(人)       
frequent       	/'fri:kwənt/        	a.时常发生的,频繁的         
hum            	/hʌm/               	v.哼曲子；发嗡嗡声；忙碌n.嗡嗡声，嘈杂声
boss           	/bɔs/               	n.老板，上司 vt.指挥，控制，发号施令
sponsor        	/'spɔnsə/           	n.发起人,主力者,保证人 v.发起,主办
boom           	/bu:m/              	v.迅速发展,兴旺;发出隆隆声     
telegraph      	/'teligrɑ:f/        	n.电报机,电报 v.打电报,发电报  
spot           	/spɔt/              	n.斑点;地点 v.认出,认清,发现;玷污,弄脏
detector       	/dɪ'tektə(r)/       	n.发现者,侦察器,探测器,检波器,检电器
sprout         	/spraut/            	vi.发芽，抽条 vt.使发芽 n.新芽，嫩苗
setback        	/'setbæk/           	n.挫折；失效；复发；倒退       
speaker        	/'spi:kə/           	n.说话者，发言者；说某种语言者；扬声器
originate      	/ə'ridʒəneit/       	v.(in,from)起源,发生;首创,创造
pronounce      	/prəu'nauns/        	v.发…的音;宣布,宣判        
revelation     	/ˌrevə'leiʃən/      	n.揭示,揭露,显示,启示,新发现,被揭露的事
cradle         	/'kreidl/           	n.摇篮;发源地            
develop        	/di'veləp/          	v.发展,开发,研制;显现,显影;发育,生长
sofa           	/'səufə/            	n.长沙发，沙发            
arrive         	/ə'raɪv/            	vi.到达；(时间、事件)到来，发生；达到
