important      	/im'pɔ:tənt/        	a.重要的,重大的;有地位的,有权力的 
trolley        	/'trɔli/            	n.手推车;(英)无轨电车,(美)有轨电车
musical        	/'mju:zikəl/        	a.音乐的;有音乐才能的 n.音乐片  
sick           	/sɪk/               	a.有病的,患病的;恶心的,想吐的   
found          	/faund/             	vt.建立;创立;创办;使有根据;铸造;熔制
articulate     	/ɑ:'tɪkjuleɪt/      	a.善于表达的；有关节相连的 v.清楚地讲话
historical     	/his'tɔrikəl/       	a.历史的;有关历史的         
organism       	/'ɔ:gənizəm/        	n.生物，有机体            
taste          	/teist/             	v.品尝;(of)有…味道;体验 n.滋味;味觉
none           	/nʌn/               	pron.没有任何人(东西)；都不 ad.一点也不
void           	/vɔid/              	a.空虚的;没有的;无效的       
apt            	/æpt/               	a.恰当的，适当的；易于…的，有…倾向的
participate    	/pɑ:'tɪsɪpeɪt/      	v.(in)参与,参加;分享,分担;含有,带有
immune         	/i'mju:n/           	a.免疫的,有免疫力的;有受影响的;豁免的
eloquent       	/'eləkwənt/         	a.雄辩的,有说服力的;善辩的,口才流利的
dubious        	/'dju:bjəs/         	a.怀疑的，无把握的；有问题的，靠不住的
sometimes      	/'sʌmtaimz/         	ad.不时，有时，间或         
moderate       	/'mɔdərət/          	a.有节制的,中等的,适度的,温和的,稳健的
threaten       	/'θretən/           	v.恐吓,威胁;有…危险,快要来临   
motel          	/məu'tel/           	n.(附有停车场的)汽车旅馆      
your           	/jɔ:/               	pron.[you的所有格]你的，你们的
thing          	/θiŋ/               	n.物，东西；事，事情；所有物；局面，情况
hold           	/həuld/             	v.拿着;保有;托住;举行;继续 n.握住;船舱
poisonous      	/'pɔizənəs/         	a.有毒的,恶意的,恶毒的,道德败坏的 
favorable      	/'feivərəbl/        	a.(favourable)赞许的,有利的,讨人喜欢的
bitter         	/'bitə/             	a.(有)苦(味)的;痛苦的,厉害的  
condemn        	/kən'dem/           	v.谴责,指责;判刑,宣告有罪     
resistant      	/ri'zistənt/        	a.(to)抵抗的,有抵抗力的     
van            	/væn/               	n.有篷汽车;有篷货运车厢       
capable        	/'keipəbl/          	a.有本领的,有能力的;(of)可以…的,能…的
profitable     	/'prɔfitəbl/        	a.有利可图的,有益的         
common         	/'kɔmən/            	a.普通的；共同的；一般的；n.公有地
characteristic 	/ˌkærəktə'ristik/   	a.(of)特有的,独特的 n.特征,特性
finite         	/'fainait/          	a.有限的；[数]有穷的,限定的    
