snow           	/snəu/              	n.雪，下雪 vi.下雪；如雪一般地落下
important      	/im'pɔ:tənt/        	a.重要的,重大的;有地位的,有权力的 
locality       	/ləu'kæləti/        	n.位置,地点             
fairly         	/'fεəli/            	ad.公正地,正当地;相当,还算    
local          	/'ləukəl/           	a.地方的,当地的;局部的       
destination    	/ˌdesti'neiʃən/     	n.目的地,终点            
mostly         	/'məustli/          	ad.几乎全部地;主要地,大部分,基本上
articulate     	/ɑ:'tɪkjuleɪt/      	a.善于表达的；有关节相连的 v.清楚地讲话
assault        	/ə'sɔ:lt/           	v.猛烈地攻击，袭击 n.突然而猛烈的攻击
enough         	/i'nʌf/             	a.(for)足够的 n.足够,充分 ad.足够地
pasture        	/'pɑ:stʃə/          	n.牧草地,牧场            
somehow        	/'sʌmhau/           	ad.以某种方式，用某种方法；不知怎么地
interior       	/in'tiəriə/         	a.内部的,里面的 n.内部,内地   
brave          	/breiv/             	a.勇敢的 v.勇敢地面对(危险等)  
locate         	/ləu'keit/          	v.查出,探出,查找…地点,使…坐落于,位于
quick          	/kwik/              	a.快的;灵敏的,伶俐的;敏锐的 ad.快,迅速地
likewise       	/'laikwaiz/         	ad.同样地,照样地;又,也,而且   
half           	/hɑ:fˌ hæf/         	n.半，一半 a.一半的，不完全的 ad.一半地
slave          	/sleiv/             	n.奴隶,苦工 v.做苦工,拼命地干  
cemetery       	/'semitəri/         	n.坟墓，墓地，坟场          
assign         	/ə'sain/            	vt.派给，分配；选定，指定(时间、地点等)
grass          	/grɑ:s/             	n.草，草地              
jungle         	/'dʒʌŋgl/           	n.丛林,生死地带           
wholly         	/'həuli/            	ad.完全地,全部,一概        
strange        	/streindʒ/          	a.奇怪的,奇异的;陌生的,生疏的;外地的
spot           	/spɔt/              	n.斑点;地点 v.认出,认清,发现;玷污,弄脏
accordingly    	/ə'kɔ:dɪŋli/        	ad.相应地，照着办，按照；于是，因此 
room           	/ru:m/              	n.房间，室，空间，地方；余地     
meadow         	/'medəu/            	n.草地,牧场             
height         	/hait/              	n.高,高度;(常pl.)高地,高处  
straightforward	/ˌstreit'fɔ:wəd/    	a.正直的;简单的,易懂的 ad.坦率地
dead           	/ded/               	a.死的；无生命的；死气沉沉的 ad.完全地
native         	/'neitiv/           	a.本地的,本国的;天生的 n.本地人,本国人
indeed         	/in'di:d/           	ad.确实,实在;真正地,多么     
console        	/kən'səul /         	n.控制台，仪表板；落地柜 vt.安慰，慰问
tight          	/tait/              	a.紧的;紧身的,装紧的;密封的 ad.紧紧地
bang           	/bæŋ/               	n.砰砰的声音;猛击 v.砰地关上,猛撞,猛击
well           	/wel/               	ad.好，令人满意地；很 int.哎呀，好啦，嗯
cradle         	/'kreidl/           	n.摇篮;发源地            
common         	/'kɔmən/            	a.普通的；共同的；一般的；n.公有地
hell           	/hel/               	n.地狱,阴间;苦境,极大痛苦     
landlady       	/'lænd/             	n.女房东,女地主           
premise        	/pri'maiz/          	n.前提,房屋连地基v.提论,预述,假定
